------------------------------------------------------------------------------------------------------------------------------------------------------------X--------------------------------------------
-----------------------------------------------------------------------------------------------------------------------------------------------------------------------------------------------------BB--
------------------X--------------------------------------------------------------------------------------------------------------------------------------------------------------------------------------
-------------------------------------------------------------------------------------------------------------------------------------------------------------------------------------------------BB------
---------------------------------------------------------------------------------------------------------------------------------------------------------------------------------------------------------
---------------------------------------------------------------------------------------------------------------------------------------------------------------------------------------------------------
-------------------------------------------------------------------------------------------------------------------------X-------------------------------------------------------------------------------
---------------------------------XX----------------------BB------------------o------------------B----------------------------o-----------------E---E--------XB---------o?B----------------X---------EBBv-
-------------------------------------------------------------------------------------------------------------------------------------------------B---------------------o-------------B-----------------f-
-----E-----------------------------------------E----------------BB-------------------------------------------------X-------------o-------------------------------------------------------------E-------f-
----BX--o--B----Xo-M------o-----------o----B--------------?X----------?-?-B----X-T-----BB-------B?--?-------------------------------o--o------EXB---B-B----E--XBBXXX-o----B-?oT----------o--?M---------f-
-?-----------o------BX-o--T--o----o------T-----------------------T-o---B----T----|T-o---------BX---------B-o------oo--B-------------o--------------XXB-E--XBE-B---oX-X--------|B----------------------?f-
------?-----M---T---------|B-o-----BB----|XB--------------BB--E--|--XB-----o|--XB||--------------BBX---B----E-M--BX----o--------X-------------------X--B---M-------B----------|------B---------T----B--f-
-?--BB------EB--|-----B---|T-------------|----?---E----BB-----Mo-|-M--------|M---||-----o---o----BBBB---o----------------X--E--------------T-T-------------o---BX--B-Bo-X----B|---------X------|-T-o---f-
mB-----------BB-|---oE--E-||-o-------XBB-|------BTo---B----X---E-|----------|--T-||---BBM----T--XBB-------------B--o-----?-M--B---M----TB--|-|----o-----To------oB------E----B|B-B----BB--MBX--|-|-----X-
XXXXXXXXXXXXXXXX|XXXXXXXXX||XXXXXXXXXXXX-|XXXXX-X|XXXXXXXXXXXXXXX|XXXXXXXXX-|XX|X||XXXXXXXXXX|XXXXXXX-XXXXXX-XX-XXXXXXXXXXXXXXXXXXXXXXX|XXX|X|X-XXXXXXXX|XXXXXXXXX-XXXXXX-XXXX|XXXX-XXXX-XXXXXX|X|-XXXXX-
